[
  {
    "id": 1,
    "x": 12,
    "y": 20,
    "w": 10,
    "h": 10
  },
  {
    "id": 2,
    "x": 42,
    "y": 20,
    "w": 10,
    "h": 10
  },
  {
    "id": 3,
    "x": 62,
    "y": 20,
    "w": 10,
    "h": 10
  },
  {
    "id": 4,
    "x": 45,
    "y": 20,
    "w": 10,
    "h": 10
  },
  {
    "id": 5,
    "x": 56,
    "y": 20,
    "w": 10,
    "h": 10
  },
  {
    "id": 6,
    "x": 67,
    "y": 20,
    "w": 10,
    "h": 10
  },
  {
    "id": 7,
    "x": 67,
    "y": 20,
    "w": 10,
    "h": 10
  },
  {
    "id": 8,
    "x": 67,
    "y": 20,
    "w": 10,
    "h": 10
  },
  {
    "id": 9,
    "x": 67,
    "y": 20,
    "w": 10,
    "h": 10
  },
  {
    "id": 10,
    "x": 67,
    "y": 20,
    "w": 10,
    "h": 10
  },
  {
    "id": 11,
    "x": 67,
    "y": 20,
    "w": 10,
    "h": 10
  },
  {
    "id": 12,
    "x": 67,
    "y": 20,
    "w": 10,
    "h": 10
  }
]
